hoax-->a humorous or malicious deceptionor prank
when pigs fly-->adynaton,a way of saying something will never happen. 
Adynaton-->figure of speech that is impossible to happen.
Subtleties-->a quality or state of being subtle.
discourse-->written or spoken communication.
stimulating-->encourging or arousing interestor enthusiasm.
pendown-->write down something or stop writing during an exam.Pen down is also a way of protest undertaken by the staff against the managment.
Irretrievably-->Imposible to regain or recover.
Muster-->assemble.
Summon-->order to be present.
Pious-->devoutly religious
Piety-->the quality of being religious or reverent.
envy-->a feeling of discontented,jealousy.
Incandescent-->emitting light as a result of being heated.
Flatter-->to make someone pleased and proud because someone has said good things about youand feel important.
reverent-->feeling or showing deep respect.
solemn-->former and dignified.
Metaphores-->a figure of speech in which a word or phrase is applied to an object or action to which it is not literally applicable.
sands of time-->English idiom relating the passage of time to the sand in an hourglass.
piece of advice
advise-->verb-to give counsel to;
advice-->noun
hold your horses-->wait a moment,slow down when going too fast.
inculcate-->implant,infuse,introduce.
Apple of discard-->Reason for something.
when pigs fly-->impossible event.
SSD-->solid state drive 
HDD-->hard disk drive
standalone-->work alone
elude-->escape from or avoid
wit-->a intelligent humour
tickle-->light touch in the way that causes mild discomfort and often laughter 
pitfall-->a hidden or unsuspected danger or difficulty:
implant-->insert or fix 
firm-->having a solid structure
renovate-->restore (something old, especially a building) to a good state of repair
revered-->deep respect or admiration for something
archive-->place to keep important info with protection
hazardous-->a substance that has substancial or potential threats to public
Substantial-->of considerable importance,size,worth
troupe-->a group of dancers,actors who tour to different venues
troop-->group of soldiers or scouts(head)
within a span of-->a period of time
spare-->additional one 
stare-->look fixedly with ones eyes widely open
lounge-->lie,sit in relaxed way,slump.slouch
zenith-->peak
amaze balls-->extremely good or impressive; amazing
stupify-->make (someone) unable to think or feel properly
white collar-->A white collar worker is a person who performs professional, desk, managerial, or administrative work. White-collar work may be performed in an office or other administrative setting.
birds eye view-->a general view from above
pull your socks up-->to improve your behaviour or work.
genere-->a style or category of art, music, or literature:	
Stallion-->an uncastrated adult male horse.
Castration-->removal of testicles of male animals inorder to reduce aggresion
Circumcision-->removal of foreskin from the human penis
inaugarate-->begin or introduce (a system, policy, or period).
exaggerate-->to tell about some one something beyond the limits or worse than its reality.
emphasize-->give special importance or value to (something) in speaking or writing.
cumbersome-->arge or heavy and therefore difficult to carry or use; unwieldy.
hype-->intense publicity or promotion
guage-->to estimate
endorse-->to approve or support
agile-->able to move quickly
blend-->mixture
offshoring-->the practice of basing some of a company's processes or services overseas, so as to take advantage of lower costs.
mitigate-->ease
gets butterfly-->nervousness
misogynist x philogyni
stumbling block-->a circumstance that causes difficulty or hesitation
autism-->impairs the ability to communicate and interact
procastination-->act of delaying or postponing task
ambushed-->to suddenly attack someone after hiding and waiting for them
lounging-->lie,sit in a relaxed way
acquainted-->familiar
render-->cause to become
intruder-->someone who is in a place or situation where they are not wanted
confidential-->intended to be kept secret
integrity-->the quality of being honest and having strong moral principles
breach-->an act of breaking or failing to observe a law, agreement, or code of conduct
denial-->the action of denying something
malicious-->characterized by malice; intending or intended to do harm:
malice-->the desire to harm someone; ill will:
legitimate-->conforming to the law or to rules
disguise-->a means of altering one's appearance to conceal one's identity
latency-->the state of existing but not yet being developed or manifest; concealment
       -->the delay before a transfer of data begins following an instruction for its transfer
stealth-->quietly and carefully in order not to be seen or heard
stalk-->pursue or approach stealthily
enterprise-->an organization, especially a business, or a difficult and important plan, especially one that will earn money:
reliable-->consistently good in quality or performance; able to be trusted:
throughput-->A benchmark can be used to measure throughput. In data transmission, network throughput is the amount of data moved successfully from one place to another in a given time period, and typically measured in bits per second ( bps ), as in megabits per second ( Mbps) or gigabits per second ( Gbps )
adhere-->believe in and follow the practices of
thanks though-->thanking him even though others help did not satisfy fully
fragile-->easily broken
obselete-->outdated
stern-->hard in severe in nature
charter-->authority(charted flight)
termites-->insects
shook-->past tense of shake
convoy-->group of ships or vehicles travelling
fitness freak-->significantly conscious of their health
hang over-->a severe headache due to excess alcohol
Abstract-->existing in thought or as an idea but not having a physical or concrete existence:
"abstract concepts such as love or beauty"
Etiquette-->the set of customs which control accepeted behaviour in particular social groups social situation
ex:Men cannot sit while women are standing
Cue-->word or action in a play or film which is used as a signal by a performer to begin saying or doing something
Affect(verb)
Effect(Noun)
Anticipation-->feeling of exictement about something that is going to happen in near future
Accompany-->to go with someone or to be provided(verb)
Cassette-->Device
insomia-->unable to get sleep
Cluster-->Group of similar things that are close together 
ex:people clustered around the notice board
Rendering-->the way that something is performed
Boredom-->when you are bored;
they started quarelling out of sheer boredom
sheer(Adjective)-->
used to emphasize how very great that something is
proximity-->state of being near in space or time
Diction-->the manner in which words are pronounced
Maneuver-->Clever Action
Cleverly plan something to get benefited
Claimed-->to say that some thing is true or fact irrespective of others
dodge--> to avoid being hit by something
instinctively-->done without conscious thought(adverb)
slouch-->sit/stand/walk with shoulder hanging forward and head bent(look tired)
steeple-->pointed structure on the top of the chruch
feeble-->lacking physical strength(weak)
fast-paced-->moving or developing quickly
lumpsum-->A lump sum amount is defined as a single complete sum of money. A lump sum investment is of the entire amount at one go.
chauvinstic-->strong and unreasonable belief that our own country or race is the best or most important
deficit-->total amount by which money spend is > money received
reap-->get the benefits that is from our own actions
contented-->happy and satisfaction
attainable-->possible to achieve
dread-->a feel or extremely worried or frightened that is going to happen in near future
intimate-->closely acquainted; familiar.